----------------------------------------------------------------------------------------------------------------------------------------------------------------------------------------------------------
----------------------------------------------------------------------------------------------------------------------------------------------------------------------------------------------------------
----------------------------------------------------------------------------------------------------------------------------------------------------------------------------------------------------------
----------------------------------------------------------------------------------------------------------------------------------------------------------------------------------------------------------
----------------------------------------------------------------------------------------------------------------------------------------------------------------------------------------------------------
----------------------------------------------------------------------------------------------------------------------------------------------------------------------------------------------------------
----------------------------------------------------------------------------------------------------------------------------------------------------------------------------------------------------------
----------------------------------------------------------------------------------------------------------------------------------------------------------------------------------------------------------
----------------------------------------------------------------------------------------------------------------------------------------------------------------------------------------------------------
----------------------------------------------------------------------------------------------------------------------------------------------------------------------------------------------------------
------------#--#----------------#--#----------------#--#----------------#--#----------------#--#----------------#--#----------------#--#----------------#--#----------------#--#--------------------------
-----------##--##--------------##--##--------------##--##--------------##--##--------------##--##--------------##--##--------------##--##--------------##--##--------------##--##-------------------------
----------###--###------------###--###------------###--###------------###--###------------###--###------------###--###------------###--###------------###--###------------###--###-----------------F------
---M-----####--####-------g--####--####-g--------####--####----------####--####--g-------####--####-g-----g--####--####----------####--####-g-----g--####--####----------####--####---g-------g----#------
XXXXXXXXXXXXX--XXXXXXXX--XXXXXXXXXXXXXXXXXX--XXXXXXXX--XXXXXXXXX--XXXXXXXXXXXXXXXXXX--XXXXXXX--XXXXXXXXXXXXXXXXXXXXXXXXXXXXX--XXXXXXX--XXXXXXXXXXXXXXXXXXXXXXXXXXXXXXXXXXXXXX--XXXXXXXXXXXXXXXXXXXXXXXXXXX
XXXXXXXXXXXXX--XXXXXXXX--XXXXXXXXXXXXXXXXXX--XXXXXXXX--XXXXXXXXX--XXXXXXXXXXXXXXXXXX--XXXXXXX--XXXXXXXXXXXXXXXXXXXXXXXXXXXXX--XXXXXXX--XXXXXXXXXXXXXXXXXXXXXXXXXXXXXXXXXXXXXX--XXXXXXXXXXXXXXXXXXXXXXXXXXX