----------------------------------------------------------------------------------------------------------------------------------------------------------------------------------------------------------
----------------------------------------------------------------------------------------------------------------------------------------------------------------------------------------------------------
----------------------------------------------------------------------------------------------------------------------------------------------------------------------------------------------------------
----------------------------------------------------------------------------------------------------------------------------------------------------------------------------------------------------------
----------------------------------------------------------------------------------------------------------------------------------------------------------------------------------------------------------
----------------------------------------------------------------------------------------------------------------------------------------------------------------------------------------------------------
----------------------------------------------------------------------------------------------------------------------------------------------------------------------------------------------------------
----------------------------------------------------------------------------------------------------------------------------------------------------------------------------------------------------------
----------------------------------------------------------------------------------------------------------------------------------------------------------------------------------------------------------
----------------------------------------------------------------------------------------------------------------------------------------------------------------------------------------------------------
----------------------------------------------------------------------------------------------------------------------------------------------------------------------------------------------------------
----------------------------------------------------------------------------------------------------------------------------------------------------------------------------------------------------------
----------------------------------------------------------------------------------------------------------------------------------------------------------------------------------------F-----------------
---M------------------------------------------------------------------------------------------------------------------------------------------------------------------------------------#-----------------
XXXXXXXX-XXXXXXXXXXXX-XXXXXXXXXXX-XXXXXXXXXXX-XXXXXXXXXXX-XXXXXXXXXXX-XXXXXXXXXXX-XXXXXXXXXXX-XXXXXXXXXXX-XXXXXXXXXXX-XXXXXXXXXXX-XXXXXXXXXXX-XXXXXXXXXXX-XXXXXXXXXXX-XXXXXXXXXXX-XXXXXXXXXXXXXXXXXXXXXXXX
XXXXXXXX-XXXXXXXXXXXX-XXXXXXXXXXX-XXXXXXXXXXX-XXXXXXXXXXX-XXXXXXXXXXX-XXXXXXXXXXX-XXXXXXXXXXX-XXXXXXXXXXX-XXXXXXXXXXX-XXXXXXXXXXX-XXXXXXXXXXX-XXXXXXXXXXX-XXXXXXXXXXX-XXXXXXXXXXX-XXXXXXXXXXXXXXXXXXXXXXXX
