----------------------------------------------------------------------------------------------------------------------------------------------------------------------------------------------------------
----------------------------------------------------------------------------------------------------------------------------------------------------------------------------------------------------------
----------------------------------------------------------------------------------------------------------------------------------------------------------------------------------------------------------
----------------------------------------------------------------------------------------------------------------------------------------------------------------------------------------------------------
----------------------------------------------------------------------------------------------------------------------------------------------------------------------------------------------------------
----------------------------------------------------------------------------------------------------------------------------------------------------------------------------------------------------------
----------------------------------------------------------------------------------------------------------------------------------------------------------------------------------------------------------
----------------------------------------------------------------------------------------------------------------------------------------------------------------------------------------------------------
----------------------------------------------------------------------------------------------------------------------------------------------------------------------------------------------------------
----------------------------------------------------------------------------------------------------------------------------------------------------------------------------------------------------------
----------------------------------------------------------------------------------------------------------------------------------------------------------------------------------------------------------
----------------------------------------------------------------------------------------------------------------------------------------------------------------------------------------------------------
----------------------------------------------------------------------------------------------------------------------------------------------------------------------------------------F-----------------
---M------------------------------------------------------------------------------------------------------------------------------------------------------------------------------------#-----------------
XXXXXXXX--XXXXXXXXXXX--XXXXXXXXXX--XXXXXXXXXX--XXXXXXXXXX--XXXXXXXXXX--XXXXXXXXXX--XXXXXXXXXX--XXXXXXXXXX--XXXXXXXXXX--XXXXXXXXXX--XXXXXXXXXX--XXXXXXXXXX--XXXXXXXXXX--XXXXXXXXXX--XXXXXXXXXXXXXXXXXXXXXXX
XXXXXXXX--XXXXXXXXXXX--XXXXXXXXXX--XXXXXXXXXX--XXXXXXXXXX--XXXXXXXXXX--XXXXXXXXXX--XXXXXXXXXX--XXXXXXXXXX--XXXXXXXXXX--XXXXXXXXXX--XXXXXXXXXX--XXXXXXXXXX--XXXXXXXXXX--XXXXXXXXXX--XXXXXXXXXXXXXXXXXXXXXXX
