----------------------------------------------------------------------------------------------------------------------------------------------------------------------------------------------------------
----------------------------------------------------------------------------------------------------------------------------------------------------------------------------------------------------------
----------------------------------------------------------------------------------------------------------------------------------------------------------------------------------------------------------
----------------------------------------------------------------------------------------------------------------------------------------------------------------------------------------------------------
----------------------------------------------------------------------------------------------------------------------------------------------------------------------------------------------------------
----------------------------------------------------------------------------------------------------------------------------------------------------------------------------------------------------------
----------------------------------------------------------------------------------------------------------------------------------------------------------------------------------------------------------
----------------------------------------------------------------------------------------------------------------------------------------------------------------------------------------------------------
----------------------------------------------------------------------------------------------------------------------------------------------------------------------------------------------------------
----------------------------------------------------------------------------------------------------------------------------------------------------------------------------------------------------------
----------------------------------------------------------------------------------------------------------------------------------------------------------------------------------------------------------
----------------------------------------------------------------------------------------------------------------------------------------------------------------------------------------------------------
----------------------------------------------------------------------------------------------------------------------------------------------------------------------------------------F-----------------
---M------------------------------------------------------------------------------------------------------------------------------------------------------------------------------------#-----------------
XXXXXXXX--XXXXXXXXXX--XXXXXXXXXX--XXXXXXXXXX--XXXXXXXXXX--XXXXXXXXXX--XXXXXXXXXX--XXXXXXXXXX--XXXXXXXXXX--XXXXXXXXXX--XXXXXXXXXX--XXXXXXXXXX--XXXXXXXXXX--XXXXXXXXXX--XXXXXXXXXX--XXXXXXXXXXXXXXXXXXXXXXXX
XXXXXXXX--XXXXXXXXXX--XXXXXXXXXX--XXXXXXXXXX--XXXXXXXXXX--XXXXXXXXXX--XXXXXXXXXX--XXXXXXXXXX--XXXXXXXXXX--XXXXXXXXXX--XXXXXXXXXX--XXXXXXXXXX--XXXXXXXXXX--XXXXXXXXXX--XXXXXXXXXX--XXXXXXXXXXXXXXXXXXXXXXXX
